######################################################################
#....................................................................#
#...@................................................................#
#....................................................................#
#....................................................................#
#...................~~~~~~~~~~~~.....................................#
#...................~~~~~~~~~~~~.....................................#
#...................~~~~~~~~~~~~.....................................#
#....................................................................#
#....................................................................#
#....................................................................#
#....................................................................#
#....................................................................#
#....................................................................#
#....................................................................#
#....................................................................#
#....................................................................#
#....................................................................#
#....................................................................#
#....................................................................#
#....................................................................#
#....................................................................#
#....................................................................#
#....................................................................#
#....................................................................#
#....................................................................#
#....................................................................#
#....................................................................#
######################################################################
